*X*X*********X*****X
*X*X*XXX*XXXXX*XXX*X
*X***X***X*****X*X**
*XXXXX*XXX*XXXXX*X*X
*X***X*X*********X**
*X*X*X*X*XXXXXXX*X*X
***X*X***X*X***X*X*X
XXXX*XXX*X*X*X*XXX**
***X***X***X*X*****X
*XXXXX*XXXXX*XXXXX**
*X*****X*****X***X*X
*X*XXXXX*XXXXX*XXX*X
*X***X***X*****X***X
*XXX*X*XXX*XXXXX*XXX
***X*X*X*********X**
*XXX*X*XXX*XXXXXXX*X
***X*X***X*X***X****
*X*X*XXX*X*X*X*X*X*X
*X*******X***X***X**
XXXX*X*X*X*XXX*XXXX*